Aphex Twin - Windowlicker
Bill Conti - Going the Distance
Deathgrips - Beware
Enigma - Return To Inocence
Grieg - In the Hall of the Mountain King
Harry Mack - No Regard
J-Cut & Kolt Siewerts - The Flute Tune
Little Stranger - Brain Fog
Ludacris - Move Bitch
Ocean Noises
Prince - Purple Rain
Prince Bard - Purple Rain
Queen - Underpressure
Raido - Wardruna
Sleep Token - Are You Really Okay
Scarface - Main Title
Q Lazzarus - Goodbye Horses
Kevin Macleod - Sneaky Snitch - Trap Remix
Labi Siffre - My Song
Agnes Obel  - The Curse
Gary Jules - Mad World
Halsey - Gasoline
Hollywood Undead - Save Me
JD Huggins - Who Have You Become
Jelly Roll - Save Me
Kacey Musgraves - Biscuits
Ozzy Osbourne - Road to Nowhere
Poison - Every Rose Has Its Thorn
Post Malone x Jelly Roll - Losers
Staind - Outside
Caitlynne Curtis - Been Thru Hell
Cal Scruby - Money Buy Drugs
Chas & Dave - Rabbit
Falling In Reverse - Voices In My Head
Ghost - Call Me Little Sunshine
Lena Raine - Pigstep Remix
Beethoven - Symphony No 9 4th movement
AEV1ridis - The Prophet